                                     
                                     
                                     
      I E   I                          
       GGGGG                       P 
                                     
GG    E          GG      GG    G     
DDGGGGGGGGGGGGGGGDD    GGDDG  GDGG  G
DDDDDDDDDDDDDDDDDDD    DDDDD  DDDDGGD
DDDDDDDDDDDDDDDDDDD     DD    DDDDDDD
DDDDDDDDDDDDDDDDDDD     D     DDDDDDD
DDDDDDDDDDDDDDDDDDD     D     DDDDDDD
DDDDDDDDDDDDDDDDDDD           DDDDDDD
