0000000000000000000000000000000000000
0000000000000000000000000000000000000
0000000000000000000000000000000000000
0000000000000000000000000000000000000
0000000222220000000000000000000000000
0000000000000000000000000000000000000
2200000000000000022000000220000200000
1122222222222222211000022112002122002
1111111111111111111000011111001111221
1111111111111111111000001100001111111
1111111111111111111000001000001111111
1111111111111111111000001000001111111
1111111111111111111000000000001111111